Tutorial
3 5
f f f
f p f
f s f
f g f
f f f

