Tutorial
Jelmer Firet
1 3 -1
p
s
g

