Tutorial 1
Jelmer Firet
5 5 1
f f f f f
f . p . f
f . s . f
f . g . f
f f f f f

