Tutorial 2
Jelmer Firet
5 6 1
f f f f f
f . p . f
f . s . f
f . s g f
f . g . f
f f f f f

