Tutorial 2
Jelmer Firet
3 5 8
f p f
f g f
w w w
. s .
. . .

