Tutorial 3
Jelmer Firet
6 9 13
f f f f f f
f . p . . f
f . s . . f
f w w w w f
f . . . . f
f w w . . f
f . w w w f
f . g . . f
f f f f f f

