Turnaround
Jelmer Firet
2 4 7
P f
s .
. .
. .
