Turnaround
4 6
f f f .
f P f f
f s . f
f . . f
f . . f
f f f f

