Turnaround
Jelmer Firet
2 4 -1
P f
s .
. .
. .
