Microban level 6
David Skinner
10 4 107
. . . . f f f . . .
. s s . . . . . f p
. s . f g g g . . .
. . . f f f f f f f

