Microban level 1
David Skinner
4 5 33
. g f .
. . f f
S p . .
. . s .
. . f f

