Microban level 5
David Skinner
6 5 25
f . . . . .
f . g s g .
f . s p s .
. . g s g .
. . . . . .

