Microban level 1
David Skinner
6 7 -1
f f f f . .
f . g f . .
f . . f f f
f S p . . f
f . . s . f
f . . f f f
f f f f . .

