World 2-1
Thijs van Loenhout
11 6 25
f f f f f f f f f f f
f . . . . . w g w . f
f . . . . . w w w . f
f f s f f p f f s f f
f . w w w . . . . . f
f . w g w . . . . . f
