Pastoria City
Thijs van Loenhout
7 7 27
f f w f w f f
f . w g w . f
f . w w w . f
f w W s W w f
f . w w w . f
f g w p w g f
f f w f w f f