Two legs good...
Thijs van Loenhout
9 7 43
f f f f f f f f f
f . . f f . . . f
f . . s p s . . f
f . f g f g f . f
f . . . . . . . f
f . . . f f . . f
f f f f f f f f f