Microban level 2
David Skinner
6 7 -1
f f f f f f
f . . . . f
f . f p . f
f . s S . f
f . g S . f
f . . . . f
f f f f f f

