Microban level 2
David Skinner
4 5 -1
. . . .
. f p .
. s S .
. g S .
. . . .

