Tricky one-ways
Jelmer Firet
11 10 83
. p . . . . w f . . .
. . g s g . w w S w w
f f . f . f f f f w f
w w W g W w w w f w .
. . w w w . . w f w w
f f f w f f f w f f .
. . S w w f . w S . .
. f s . w f . . s f .
. f g f f f f f g f .
. . . . . . . . . . .