Water Challenge
Jelmer Firet
7 7 38
# f f f f f #
f f . g g f #
f . . w f f f
f . s w w w f
f . s w f w f
f . p w w w f
f f f f f f f