Microban level 3
David Skinner
9 6 -1
. . f f f f . . .
f f f . . f f f f
f . . . . . s . f
f . f . . f s . f
f . g . g . p . f
f f f f f f f f f

