Microban level 3
David Skinner
7 4 33
f f . . f f f
. . . . . s .
. f . . f s .
. g . g . p .

