Generated 5
JSF-Laptop
6 6 -1
f f f f f f
w . w . w w
w s . f w f
. f g f w f
. p f f . f
f f f f . .