Microban level 4
David Skinner
8 6 -1
f f f f f f f f
f . . . . . . f
f . g S S s p f
f . . . . . . f
f f f f f . . f
. . . . f f f f

