Microban level 4
David Skinner
6 4 -1
. . . . . .
. g S S s p
. . . . . .
f f f f . .

