Microban level 6
David Skinner
12 6 -1
. . . . f f f . . .
. s s . . . . . f p
. s . f g g g . . .
. . . f f f f f f f

