Microban level 7
David Skinner
5 6 30
. . . . .
. g s g .
. s g s .
. g s g .
. s g s .
. . p . .