Microban level 7
David Skinner
7 8 -1
f f f f f f f
f . . . . . f
f . g s g . f
f . s g s . f
f . g s g . f
f . s g s . f
f . . p . . f
f f f f f f f

