Microban level 8
David Skinner
8 9 79
. . f f f f f f
. . f . g g p f
. . f . s s . f
f f f f . f f f
f . . . . f f .
f . f . . . f .
f . . . f . f .
f f f . . . f .
. . f f f f f .


