Johnstown
Thijs van Loenhout
6 6 22
f f f f f f
f . . . . f
f . s w w w
w w W w . .
f p . . g g
f f f f f f