O Green World
Thijs van Loenhout
9 8 31
. . f f f f f . .
. f f . . . f f .
f f . . . . . f f
f . . f w f . . f
f . . s s s . . f
f . . g g g . . f
f f f . p . f f f
. . f f f f f . .