Four legs better?
Thijs van Loenhout
7 5 41
f f f f f . w
. . . . . . .
w w f f f . .
w . S p s w w
w w w f f w g