Generated 4
JSF-Laptop
6 6 16
# # f g f #
f f f . f f
p s g s g f
W . g s s g
g f W . W .
f f g f . w