9999_test_05_00.sok, Generated V2 1, SCC-DAG, 19
9999_test_05_01.sok, Generated V2 2, SCC-DAG, 23
9999_test_05_02.sok, Generated V2 2, SCC-DAG, 100