Sprite Tester
Jelmer Firet
11 15 -1
s s w s s s s s s . f
S w w w S S w . w . #
w w S w w S w S S . f
g w w w p w w w w . #
. . w . . . w . . . f
. . f . . . . . . . #
. f f f . . f . f . f
f f . f f . f . . . #
. f f f . f f f f . f
. . f . . . f . . . #
. . W . . . . . . . f
. W W W . . W . W . #
W W . W W . W . . . f
. W W W . W W W W . #
. . W . . . W . . . f