Generated 7
JSF-laptop
6 6 9
f f . g f f
f g W s f g
f f g W . W
# f f s f w
# # f g p w
# # f f f f