Generated V2 1
SCC-DAG
5 5 19
g . . . .
. . . . .
. . f . .
g . s s s
. . . S P