Generated 1
JSF-Laptop
6 6 20
f f p W g f
f g W w w f
f w s w s g
f . w w . g
f . W g f f
f f f f f #