Generated 10
JSF-Laptop
6 6 7
# # # # # #
# # # f f f
# # # f g w
# f f f s w
# f g s p .
# f f g s .