9999_test_04_00.sok, Generated 1, JSF-Laptop, 20
9999_test_04_01.sok, Generated 2, JSF-Laptop, 11
9999_test_04_02.sok, Generated 3, JSF-Laptop, 7
9999_test_04_03.sok, Generated 4, JSF-Laptop, 16
9999_test_04_04.sok, Generated 5, JSF-Laptop, 7
9999_test_04_05.sok, Generated 6, JSF-Laptop, 9
9999_test_04_06.sok, Generated 7, JSF-Laptop, 9
9999_test_04_07.sok, Generated 8, JSF-Laptop, 9
9999_test_04_08.sok, Generated 9, JSF-Laptop, 8
9999_test_04_09.sok, Generated 10, JSF-Laptop, 7