Generated V2 2
SCC-DAG
5 5 100
g . . . f
. . . s g
. . f s g
. . s . .
. . p s g