Generated 8
JSF-Laptop
6 6 9
f f w w . w
f g s q . s
f f f s f .
# # f g f g
# # f f f f
# # # # # #