Generated 2
JSF-Laptop
6 6 11
# # # # # #
f f f f # #
g f g f f f
w W S f p f
. w s . . f
. w . f f f