Generated 6
JSF-Laptop
6 6 9
f f g f # #
g s s f f f
f g s . s g
f f . s g f
f g W p f f
f f f f f #