Generated V2 2
SCC-DAG
5 5 23
P S . . g
W w W s .
. f w w w
w w w . .
. . . . g