Generated 9
JSF-Laptop
6 6 -1
. f f g f #
. w w s f #
. w w . f f
f s g s . q
f g f f . .
f f f f f w