Generated 3
JSF-Laptop
6 6 -1
# # # # f .
f f f f f w
w f w w w w
w q W g f .
g W s w f f
f g . w f #