Tutorials.sok, Tutorials, , 0
Microban.sok, Microban, David Skinner, 0
Thijs.sok, Thijs' levels, Thijs van Loenhout, 0
Jelmer.sok, Jelmer's levels, Jelmer Firet, 0
9999_test_Generated.sok, Generated levels, JSF-Laptop, 0
9999_test_Debug.sok, Debug levels, Jelmer Firet, 0
9999_test_Generated_2.sok, Generated levels 2, SCC-DAG, 0
