Tutorials.sok, Tutorials, , 0
Microban.sok, Microban, David Skinner, 0
Thijs.sok, Thijs' levels, Thijs van Loenhout, 0
Jelmer.sok, Jelmer's levels, Jelmer Firet, 0
Generated.sok, Generated levels, JSF-Laptop, 0
Debug.sok, Debug levels, Jelmer Firet, 0