9999_test_texture.sok, Sprite Tester, Jelmer Firet, -1