03_00.sok, Water Challenge, Jelmer Firet, 38
03_01.sok, Tricky one-ways, Jelmer Firet, 83