01_00.sok, Microban 1, David Skinner, 33
01_01.sok, Microban 2, David Skinner, 16
01_02.sok, Microban 3, David Skinner, 19
01_03.sok, Microban 4, David Skinner, 23
01_04.sok, Microban 5, David Skinner, 25
01_05.sok, Microban 6, David Skinner, 107
01_06.sok, Microban 7, David Skinner, 28
01_07.sok, Microban 8, David Skinner, 79
