02_00.sok, Johnstown, Thijs van Loenhout, 20
02_01.sok, O Green World, Thijs van Loenhout, 31
02_02.sok, Johnstown, Thijs van Loenhout, 20
02_03.sok, Two legs good..., Thijs van Loenhout, 43
02_04.sok, Four legs better?, Thijs van Loenhout, 20
02_05.sok, Maze, Thijs van Loenhout, 41
02_06.sok, World 2-1, Thijs van Loenhout, 25
02_07.sok, Pastoria City, Thijs van Loenhout, 27