00_0.sok, Tutorial 1, Jelmer Firet, 1
00_1.sok, Tutorial 2, Jelmer Firet, 8
00_2.sok, Tutorial 3, Jelmer Firet, 8
00_3.sok, Tutorial 4, Jelmer Firet, 13